"filename", "language", "Markdown", "CSS", "HTML", "XML", "JavaScript", "comment", "blank", "total"
"h:\前端工程\Readme.md", "Markdown", 1, 0, 0, 0, 0, 0, 1, 2
"h:\前端工程\ThreeJS实验\3D.js", "JavaScript", 0, 0, 0, 0, 23623, 3080, 17535, 44238
"h:\前端工程\ThreeJS实验\Three3D.js", "JavaScript", 0, 0, 0, 0, 27598, 1190, 6790, 35578
"h:\前端工程\ThreeJS实验\index.html", "HTML", 0, 0, 45, 0, 0, 0, 3, 48
"h:\前端工程\前端基础课程\CSS\demo.css", "CSS", 0, 5, 0, 0, 0, 0, 0, 5
"h:\前端工程\前端基础课程\demo.html", "HTML", 0, 0, 16, 0, 0, 0, 2, 18
"h:\前端工程\前端基础课程\index.html", "HTML", 0, 0, 110, 0, 0, 0, 2, 112
"h:\前端工程\前端练习(CSS)-CSSTooltip\CSS\CSSTooltip.css", "CSS", 0, 25, 0, 0, 0, 0, 0, 25
"h:\前端工程\前端练习(CSS)-CSSTooltip\index.html", "HTML", 0, 0, 18, 0, 0, 0, 0, 18
"h:\前端工程\前端练习(CSS)-CSS列表，背景，表格样式\CSS\CSSTest.css", "CSS", 0, 51, 0, 0, 0, 0, 3, 54
"h:\前端工程\前端练习(CSS)-CSS列表，背景，表格样式\imags.html", "HTML", 0, 0, 32, 0, 0, 0, 4, 36
"h:\前端工程\前端练习(CSS)-CSS列表，背景，表格样式\index.html", "HTML", 0, 0, 55, 0, 0, 0, 8, 63
"h:\前端工程\前端练习(CSS)-CSS动画\CSS\TransitionCSS.css", "CSS", 0, 19, 0, 0, 0, 8, 4, 31
"h:\前端工程\前端练习(CSS)-CSS动画\index.html", "HTML", 0, 0, 16, 0, 0, 0, 3, 19
"h:\前端工程\前端练习(CSS)-CSS定位\CSS\PostionCSS.css", "CSS", 0, 15, 0, 0, 0, 2, 2, 19
"h:\前端工程\前端练习(CSS)-CSS定位\index.html", "HTML", 0, 0, 16, 0, 0, 0, 1, 17
"h:\前端工程\前端练习(CSS)-CSS布局\CSS\CSSPosition.css", "CSS", 0, 63, 0, 0, 0, 0, 9, 72
"h:\前端工程\前端练习(CSS)-CSS布局\index.html", "HTML", 0, 0, 85, 0, 0, 0, 7, 92
"h:\前端工程\前端练习(CSS)-CSS文本样式练习\CSS\CSSTest.css", "CSS", 0, 37, 0, 0, 0, 0, 5, 42
"h:\前端工程\前端练习(CSS)-CSS文本样式练习\index.html", "HTML", 0, 0, 27, 0, 0, 0, 0, 27
"h:\前端工程\前端练习(CSS)-CSS模态框\CSS\CSSDialog.css", "CSS", 0, 39, 0, 0, 0, 0, 1, 40
"h:\前端工程\前端练习(CSS)-CSS模态框\index.html", "HTML", 0, 0, 24, 0, 0, 0, 0, 24
"h:\前端工程\前端练习(CSS)-CSS浮动相关练习\CSS\CSSFloat.css", "CSS", 0, 51, 0, 0, 0, 0, 2, 53
"h:\前端工程\前端练习(CSS)-CSS浮动相关练习\CSS\CSSSlidBarThree.css", "CSS", 0, 19, 0, 0, 0, 0, 0, 19
"h:\前端工程\前端练习(CSS)-CSS浮动相关练习\CSS\CSSSlidBarTwo.css", "CSS", 0, 12, 0, 0, 0, 0, 2, 14
"h:\前端工程\前端练习(CSS)-CSS浮动相关练习\SlidBarThree.html", "HTML", 0, 0, 20, 0, 0, 0, 6, 26
"h:\前端工程\前端练习(CSS)-CSS浮动相关练习\SlidBarTwo.html", "HTML", 0, 0, 18, 0, 0, 0, 6, 24
"h:\前端工程\前端练习(CSS)-CSS浮动相关练习\index.html", "HTML", 0, 0, 33, 0, 0, 0, 7, 40
"h:\前端工程\前端练习(CSS)-Google搜索框\CSS\GoogleCSS.css", "CSS", 0, 75, 0, 0, 0, 0, 10, 85
"h:\前端工程\前端练习(CSS)-Google搜索框\CSS\ImageCSS.css", "CSS", 0, 4, 0, 0, 0, 0, 1, 5
"h:\前端工程\前端练习(CSS)-Google搜索框\Images\google_logo.svg", "XML", 0, 0, 0, 1, 0, 0, 0, 1
"h:\前端工程\前端练习(CSS)-Google搜索框\index.html", "HTML", 0, 0, 27, 0, 0, 0, 2, 29
"h:\前端工程\前端练习(CSS)-Grid布局\CSS\IndexCSS.css", "CSS", 0, 37, 0, 0, 0, 0, 4, 41
"h:\前端工程\前端练习(CSS)-Grid布局\Center1.html", "HTML", 0, 0, 27, 0, 0, 0, 0, 27
"h:\前端工程\前端练习(CSS)-Grid布局\Center2.html", "HTML", 0, 0, 27, 0, 0, 0, 0, 27
"h:\前端工程\前端练习(CSS)-Grid布局\Center3.html", "HTML", 0, 0, 26, 0, 0, 0, 0, 26
"h:\前端工程\前端练习(CSS)-Grid布局\Center4.html", "HTML", 0, 0, 27, 0, 0, 0, 0, 27
"h:\前端工程\前端练习(CSS)-Grid布局\Center5.html", "HTML", 0, 0, 26, 0, 0, 0, 0, 26
"h:\前端工程\前端练习(CSS)-Grid布局\Center6.html", "HTML", 0, 0, 28, 0, 0, 0, 0, 28
"h:\前端工程\前端练习(CSS)-Grid布局\Center7.html", "HTML", 0, 0, 30, 0, 0, 0, 0, 30
"h:\前端工程\前端练习(CSS)-Grid布局\Center8.html", "HTML", 0, 0, 29, 0, 0, 0, 0, 29
"h:\前端工程\前端练习(CSS)-Grid布局\Center9.html", "HTML", 0, 0, 33, 0, 0, 0, 0, 33
"h:\前端工程\前端练习(CSS)-Grid布局\GridCase.html", "HTML", 0, 0, 45, 0, 0, 0, 0, 45
"h:\前端工程\前端练习(CSS)-Grid布局\GridNuggets.html", "HTML", 0, 0, 36, 0, 0, 0, 0, 36
"h:\前端工程\前端练习(CSS)-Grid布局\Index.html", "HTML", 0, 0, 75, 0, 0, 0, 5, 80
"h:\前端工程\前端练习(CSS)-flex布局\CSS\IndexCSS.css", "CSS", 0, 37, 0, 0, 0, 0, 4, 41
"h:\前端工程\前端练习(CSS)-flex布局\ThreeBar.html", "HTML", 0, 0, 67, 0, 0, 0, 2, 69
"h:\前端工程\前端练习(CSS)-flex布局\ThreeBar2.html", "HTML", 0, 0, 56, 0, 0, 0, 2, 58
"h:\前端工程\前端练习(CSS)-flex布局\Trisection.html", "HTML", 0, 0, 31, 0, 0, 0, 3, 34
"h:\前端工程\前端练习(CSS)-flex布局\TwoBar.html", "HTML", 0, 0, 49, 0, 0, 0, 5, 54
"h:\前端工程\前端练习(CSS)-flex布局\VerticalCenter.html", "HTML", 0, 0, 29, 0, 0, 0, 2, 31
"h:\前端工程\前端练习(CSS)-flex布局\index.html", "HTML", 0, 0, 47, 0, 0, 0, 3, 50
"h:\前端工程\前端练习(CSS)-层叠上下文\BFC.html", "HTML", 0, 0, 11, 0, 0, 0, 1, 12
"h:\前端工程\前端练习(CSS)-层叠上下文\CSS\IndexCSS.css", "CSS", 0, 37, 0, 0, 0, 0, 4, 41
"h:\前端工程\前端练习(CSS)-层叠上下文\CSS\StackContextCSS1.css", "CSS", 0, 28, 0, 0, 0, 0, 0, 28
"h:\前端工程\前端练习(CSS)-层叠上下文\StackContext1.html", "HTML", 0, 0, 24, 0, 0, 0, 0, 24
"h:\前端工程\前端练习(CSS)-层叠上下文\StackContext2.html", "HTML", 0, 0, 12, 0, 0, 0, 1, 13
"h:\前端工程\前端练习(CSS)-层叠上下文\StackContext3.html", "HTML", 0, 0, 11, 0, 0, 0, 1, 12
"h:\前端工程\前端练习(CSS)-层叠上下文\StackContext4.html", "HTML", 0, 0, 11, 0, 0, 0, 1, 12
"h:\前端工程\前端练习(CSS)-层叠上下文\StackContext5.html", "HTML", 0, 0, 57, 0, 0, 0, 2, 59
"h:\前端工程\前端练习(CSS)-层叠上下文\index.html", "HTML", 0, 0, 47, 0, 0, 0, 6, 53
"h:\前端工程\前端练习(CSS)-盒模型，块模型,外边距合并\BlockAndInlineCase.html", "HTML", 0, 0, 16, 0, 0, 0, 0, 16
"h:\前端工程\前端练习(CSS)-盒模型，块模型,外边距合并\BlockCase.html", "HTML", 0, 0, 15, 0, 0, 0, 0, 15
"h:\前端工程\前端练习(CSS)-盒模型，块模型,外边距合并\CSS\BlockAndInlineCaseCSS.css", "CSS", 0, 6, 0, 0, 0, 0, 0, 6
"h:\前端工程\前端练习(CSS)-盒模型，块模型,外边距合并\CSS\BlockCase.css", "CSS", 0, 15, 0, 0, 0, 0, 0, 15
"h:\前端工程\前端练习(CSS)-盒模型，块模型,外边距合并\CSS\DisplayCaseCSS.css", "CSS", 0, 0, 0, 0, 0, 0, 1, 1
"h:\前端工程\前端练习(CSS)-盒模型，块模型,外边距合并\CSS\IndexCSS.css", "CSS", 0, 37, 0, 0, 0, 0, 4, 41
"h:\前端工程\前端练习(CSS)-盒模型，块模型,外边距合并\CSS\InlineBlockCase.css", "CSS", 0, 13, 0, 0, 0, 0, 0, 13
"h:\前端工程\前端练习(CSS)-盒模型，块模型,外边距合并\CSS\MarginCase.css", "CSS", 0, 12, 0, 0, 0, 0, 0, 12
"h:\前端工程\前端练习(CSS)-盒模型，块模型,外边距合并\CSS\NavBarCase.css", "CSS", 0, 22, 0, 0, 0, 0, 2, 24
"h:\前端工程\前端练习(CSS)-盒模型，块模型,外边距合并\DisplayCase.html", "HTML", 0, 0, 11, 0, 0, 0, 1, 12
"h:\前端工程\前端练习(CSS)-盒模型，块模型,外边距合并\Index.html", "HTML", 0, 0, 51, 0, 0, 0, 5, 56
"h:\前端工程\前端练习(CSS)-盒模型，块模型,外边距合并\InlineBlockCase.html", "HTML", 0, 0, 17, 0, 0, 0, 0, 17
"h:\前端工程\前端练习(CSS)-盒模型，块模型,外边距合并\MarginCase.html", "HTML", 0, 0, 15, 0, 0, 0, 0, 15
"h:\前端工程\前端练习(CSS)-盒模型，块模型,外边距合并\NavBarCase.html", "HTML", 0, 0, 17, 0, 0, 0, 0, 17
"h:\前端工程\前端练习(Html)-CSS选择器\CSS\index.css", "CSS", 0, 57, 0, 0, 0, 0, 6, 63
"h:\前端工程\前端练习(Html)-CSS选择器\index.html", "HTML", 0, 0, 59, 0, 0, 0, 4, 63
"h:\前端工程\前端练习(Html)-input标签与表单练习\CSS\input.css", "CSS", 0, 0, 0, 0, 0, 0, 1, 1
"h:\前端工程\前端练习(Html)-input标签与表单练习\index.html", "HTML", 0, 0, 52, 0, 0, 2, 6, 60
"h:\前端工程\前端练习(Html)-input标签与表单练习\index2.html", "HTML", 0, 0, 37, 0, 0, 0, 6, 43
"h:\前端工程\前端练习(Html)-input标签与表单练习\register.html", "HTML", 0, 0, 11, 0, 0, 0, 1, 12
"h:\前端工程\前端练习(Html)-简单书库系统\CSS\book.css", "CSS", 0, 33, 0, 0, 0, 0, 2, 35
"h:\前端工程\前端练习(Html)-简单书库系统\CSS\stackRoom.css", "CSS", 0, 74, 0, 0, 0, 0, 7, 81
"h:\前端工程\前端练习(Html)-简单书库系统\book.html", "HTML", 0, 0, 22, 0, 0, 0, 0, 22
"h:\前端工程\前端练习(Html)-简单书库系统\index.html", "HTML", 0, 0, 86, 0, 0, 0, 6, 92
"h:\前端工程\前端练习(小功能)-抽奖系统\CSS\RollCSS.css", "CSS", 0, 0, 0, 0, 0, 0, 1, 1
"h:\前端工程\前端练习(小功能)-抽奖系统\index.html", "HTML", 0, 0, 20, 0, 0, 0, 2, 22
"h:\前端工程\前端练习基础(CSS)-Grid实现两栏布局\CSS\index.css", "CSS", 0, 28, 0, 0, 0, 0, 0, 28
"h:\前端工程\前端练习基础(CSS)-Grid实现两栏布局\index.html", "HTML", 0, 0, 26, 0, 0, 0, 0, 26
"Total", "-", 1, 851, 1858, 1, 51221, 4282, 24517, 82731